11111111111111
10000000000001
10000000000001
10000000000001
10000000000001
10000000000001
10000000000001
1E00000CCC00P1
11111111111111
10101111111111
11111111111111
