11111111111111111111
1P000000000000000001
10111001110011C11101
10000000000000000001
10000000000100000001
10000000000100000001
1011111100C111011101
10000000000000000001
10000000000010000001
1000000000001E000001
11111111111111111111
10101010111111111111
11111111111111111111
