11111111111111111111
1PCCCCCE100000000001
10111110111111010101
10000000000000000001
10000000000000000001
11111111111111111111
10101010111111111111
11111111111111111111
