111111111
1000000E1
100000001
100000001
100000001
100000001
100000001
100000001
1P0C00001
111111111
101010101
111111111
