1111111111111111111111111
1PCCCCCCCCCCCCCCCCCCCCE11
1111111111111111111111111
