11111
1011
1E11
1C11
1011
1011
1011
1011
1011
1P11
1111
1111
