111111
100001
1P11E1
1000C1
111110
