111111
1P11C1
100001
100001
1E11E1
111111
