111111
1000P1
11C101
1C0001
1000C1
111101
1C1101
100101
100001
1E0011
1001C1
111111
