111111
100P01
1P1111
10EP01
100011
1E0001
111111
