111111111
1000000E1
1111CC111
100011001
1000000P1
111111111
